0000000000000000000000000000000000000000000000000000000000000000000000000000000000000000000000000000000000000000000000000000000
0000000000000000000000000000000000000000000000000000000000000000000000000000000000000000000000000000000000000000000000000000000
0000000000000000000000000000000000000000000000000000000000000000000000000000000000000000000000000000000000000000000000000000000
0000000000000000000000000000000000000000000000000000000000000000000000000000000000000000000000000000000000000000000000000000000
0000000000000000000000000000000000000000000000000000000000000000000000000000000000000000000000000000000000000000000000000000000
0000000000000000000000000000000000000000000000000000000000000000000000000002220000200000000000000000000000000000000000000000000
0000000000000000000000000000000000000000000000000000000000000000000000000000000000000000000000000000000000000000000000000000000
0000000000000000000000000000000000000000000200000000000000000000000011000000000000000010000000000000000000000000000000000000000
0000000000000000002200000000000000000000000000000000000000000000000033000000000000000033100000000000000000000000000000000000000
0000000000000000000000000000000000000220000000002200000000000000000133000000000000000033331000000000000000000000000000000000000
0000000000220000000000000220000011000000000000000000000000000000000333000000000000000033333310000000000000000000000000000000000
0000000000000000000000000000000133000000000000000000000200000000001333000000000000000033333330000000044000000044400000000000000
1100000000000000000000000000004333000000000000000000000000000111113333311111111111111133333333111111111111111111111111111111111
3331111144411111111111441111443333444444444444444444444444444333333333333333333333333333333333333333333333333333333333333333333
3333333333333333333333333333333333333333333333333333333333333333333333333333333333333333333333333333333333333333333333333333333
3333333333333333333333333333333333333333333333333333333333333333333333333333333333333333333333333333333333333333333333333333333
3333333333333333333333333333333333333333333333333333333333333333333333333333333333333333333333333333333333333333333333333333333